-----------------------------------------------------------------------------------------------------------------------------------------------------------------------------------------------------
-----------------------------------------------------------------------------------------------------------------------------------------------------------------------------------------------------
-------------------------------------------------------------------------------------------------------------------------------------------------------------------------------------------------E---
-----------------------------------------------------------------------------------------------------------------------------------------------------------------------------------------------------
------------------------------------------------------------------------------------------------------------------------------------------------E----------------------------------------------------
---------------------------------------------------------------------------S-------SSS------------------SSQSSS?SSS--------SSS------------------SQS--SQS--------------------------------XXX-----------
--------------------------------------------------------------------------------------------------------------------------------------------------------------------------------------XXXX-----------
--------------------------------------------------------------------------------------------------------------------------------------XX-------------------------o------XX-----------EXXXX-----------
------------Q--?----------------E-----------------------------------------D-DD-------------------E------------------------SSS--------XXX--------------------------E-----XX----------XXXXXX-----------
---------Q-E------ESSS----E----<>------------------E--S--------------X--------XX-XX-------------<>------SSSSSSSSSSS-----------------XXXX-------SQS--S?S--------SSSSS----XX---------XXXXXXX-----------
-----------E-------------<>-----------------------<>---------E------XXX-------XX-XX------------------------------------------------XXXXX--------------------E--E-------XXX-------EXXXXXXXX-----------
------------------------------------------------------------<>-----XXXX-------XX-XXX----------------------------------------------XXXXXX---------------------------E---XXX-------XXXXXXXXX-----------
------------------------------E-------------EE-E-----E------------XXXX--------X--XXX--E-E---E------------------------------------XXXXXXX-----E-----E-------------------XXX------XXXXXXXXXX-------XX--
XXXXXXXXXXXXXXXXXXXXXXXXXXXXXXXXXXXXXX---XXXXXXXXXXXXXXXXXXXXXXXXXXXXX--------X--XXXXXXXXXXXXXXXXXXXXXXXXXXXXXXXXXXXXXXXX----XXXXXXXXXX--XXXXXXXXXXXXXXXXXXXXXXXXXXXXXXXXX---XXXXXXXXXXXXXXXXXXXXXXXX